111111111111111111
1000C11000000000C1
100000000111110001
100000011100000001
1P000011E000000001
111111111111111111
