1111111111111111111111111111111111
10000000000000000000000000000000R1
1000000000000000000000000000000001
1000000000000000000000000000000001
1000000000000000000000000000000001
1000000000000000000000000000000001
1010010100100000101001000000010101
1000000000000000000000000000000001
1000000000000000000000000000000001
1000000000000000000000000000000001
1000000000000000000000000000000001
1E0000000000000C00000C000000000001
1010010100100000101001000000010101
1010010010101010001001000000010101
1010010010101010001001000000R10101
1010010010101010001001000000010101
1P0000000C00C0000000000000000000C1
1000000000000000000000000000000001
1000000000000000000000000000000R01
1000000000000000000000000000000001
1000000000000000000000000000000001
1000000000000000000000000000000001
1000000000000000000000000000000001
1010010100100000101001000000010101
1010010100100000101001000000010101
1000000000000000000000000000000001
1000000000000000000000000000000001
1111111111111111111111111111111111
