111111111111111111
1000C11000000000C1
100000000111000001
10000000010000R001
10000000C100000001
100000011100000001
10000R001111100001
111100001111100001
100C00001111100001
100000001110000001
1000000R1110000001
10001111100000R001
100C11111000110001
100000R11100110001
10000C011100110001
111100011100000001
1P000011E000000001
111111111111111111
